NO ./path_to_the_north_texture
SO ./path_to_the_south_texture
WE ./path_to_the_west_texture
EA ./path_to_the_west_texture

F 10,0,255
C 225,30,0

11111111111
10N00000001
10000000001
10001110001
10010010001
10001110001
10000000001
10000000001
11111111111