NO ./asset/wall.xpm
SO ./asset/wall.xpm
WE ./asset/wall.xpm
EA ./asset/wall.xpm

F 255,255,255
C 255,100,100

111111111111111111111111111
100100000000000000100000001
100100010000000000C00000001
1O110000000001000010000N001
100000000000000000100000001
111111111111111111111111111