NO ./asset/wall.xpm
SO ./asset/wall.xpm
WE ./asset/wall.xpm
EA ./asset/wall.xpm

F 255,255,255
C 255,100,100

11111111111 111111111
1N000000001 100000001
10111001101 100111001
100000000011100111001
100000000000000111001
100000000011101111101
10001110001 101111101
10000000001 100000001
11111111111 111111111