NO ./asset/wall.xpm
SO ./asset/wall.xpm
WE ./asset/wall.xpm
EA ./asset/wall.xpm

F 255,255,255
C 255,100,100

 1111111111 11111111
1000000000O 100000001
10111001101 100111001
100000000011100111001
100O00E0000C000111001
100000000011101111101
10001C10001 101111101
10000000001 100000001
 1111111111 11111111