NO ./asset/wall.xpm
SO ./asset/wall.xpm
WE ./asset/wall.xpm
EA ./asset/wall.xpm

F 100,30,0
C 50,10,0

11111111111111111111111111
100100000000000000100000001
100100010000000000C00000001
1O1100000000010000100000001
100000000000000000100000001
11111111111111111111111111
