NO ./asset/wall.xpm
SO ./asset/wall.xpm
WE ./asset/wall.xpm
EA ./asset/wall.xpm

F 100,30,0
C 50,10,0

11111111111111111111111111111
100C00000011000000000000C0001
10110000011100000000000010001
1001000000C000000000000010001
1011S000011100000000000010001
10000000001100000111011110001
1111C111111111011100000010001
1111C111111111011101010010001
11000000110101011100000010001
10000000000000001100000010001
10000000000000001101010010001
11000000110101000000000000001
1111C111110101000000101000001
10000000001100000100000010001
10000000000000001000100001001
10000000001000010000000001001
10000000001101000000000000001
10000000000100000001010000001
11111111111111111111111111111
