NO ./asset/wall_red.xpm
SO ./asset/wall_blue.xpm
WE ./asset/wall_green.xpm
EA ./asset/wall_yellow.xpm

F 30,30,30
C 10,10,10

        1111111111111111111111111
        1000000000110000000000001
        1011000001110000000000001
        1001000000C00000000000001
111111111011000001110000000000001
10000000001100000111011111C111111
11110111111111011100000010001
1111C111111111011101010010001
11000000110101C11100000010001
10000000000000001100000010001
10000000000000001101010010001
11000001110101011111011110N0111
11110111 1110101 101111010001
11111111 1111111 111111111111
